You are Elizabeth Bennet, and you are at Mr. Bingley's Netherfield estate. Your sister Jane is sick, so you came to visit. You hope to try help her get back to health, but you mostly want to explore the place.

pride
Exploring the estate by Melissa Oshiro
Release 1 / Serial number 141022 / Inform 7 build 6L02 (I6/v6.33 lib 6/12N) SD

Main room
A large room that leads to an office to the west, a ballroom to the east, the dining room to the north. You see a staircase next to the dining room doorway.

You can see stairs here.

>w
office
A large room with a desk and sofas. Paintings hang on one wall and large windows are on another and the kitchen door to the north.

You can see kitchen-door, desk, drawers and Bingley here.

>n
(first opening kitchen-door)

kitchen
You can see kitchen-door and pitcher here.

>i
You are carrying nothing.

>take pitcher
Taken.

>x pitcher
A white clay water pitcher that has designs of birds and flowers on it. You should pour some water for Jane, maybe.

>pour water
You take the water pitcher and pour a glass of water for Jane.

>pour pitcher
You can't see any such thing.

I beg your pardon?

>pour water
You take the water pitcher and pour a glass of water for Jane.

>i
You are carrying:
  water

>s
office
A large room with a desk and sofas. Paintings hang on one wall and large windows are on another.

You can see kitchen-door, desk and Bingley here.

>w
You can't go that way.

>e
Main room
A large room that leads to an office to the west, a ballroom to the east, the dining room to the north. You see a staircase next to the dining room doorway.

You can see stairs here.

>e
ballroom
A large spacious room with marble floors and large windows on one wall. A grand chandelier hangs from the ceiling and marble columns near the walls. Paintings hang on all walls.

You can see piano and Miss Bingley here.

>play anaconda
My anaconda don't.

>w
Main room
A large room that leads to an office to the west, a ballroom to the east, the dining room to the north. You see a staircase next to the dining room doorway.

You can see stairs here.

>up
hallway
A narrow hall with a floral carpet across the length. A bathroom is to the east and a bedroom to the north and west.

You can see stairs and Darcy here.

>n
north bedroom
A decent-sized room. A window is on the far wall and shelves line the wall to the left. A wardrobe is next to the window. You see Jane lying on the bed in the middle of the room.

You can see window (closed), wardrobe (closed) and Jane here.

>open window
You open the windows to let some fresh air in and a cool breeze flows through your hair. You have a nice view of the Netherfield estate from here. You admire the well-trimmed trees of the back garden and the lush forest in the distance.

>x jane
Your dear sick sister, lying in bed with a cold. Ask her about bingley to lift her spirits, perhaps.

* * *

I beg your pardon?

>ask jane
(for water)
(Jane first taking water)
Jane has better things to do.

>ask jane
(for water)
(Jane first taking water)
Jane has better things to do.

>ask jane about bingley
Oh, he's such a great man. He and his sister have been nothing but kind to me.

>s
hallway
A narrow hall with a floral carpet across the length. A bathroom is to the east and a bedroom to the north and west.

You can see Darcy and stairs here.

>down
You can't go that way.

>z
Time passes.

>s
Main room
A large room that leads to an office to the west, a ballroom to the east, the dining room to the north. You see a staircase next to the dining room doorway.

You can see stairs here.

>e
ballroom
A large spacious room with marble floors and large windows on one wall. A grand chandelier hangs from the ceiling and marble columns near the walls. Paintings hang on all walls.

You can see piano and Miss Bingley here.

>ask miss bingley
(for water)
(Miss Bingley first taking water)
Miss Bingley has better things to do.

>talk to miss bingley
Miss bingley asks you to play the piano.

>ask miss bingley about piano
Why don't you play something for me?

>ask miss bingley about darcy
Such a dashing man, isn't he? He never humors me though.

>ask miss bingley about jane
She's upstairs.

>play piano
Play specific notes. Maybe a scale? A nice song?

>play anaconda
My anaconda don't.

* * *

>n
(first opening kitchen-door)

kitchen
You can see kitchen-door and pitcher here.

>pour water
You take the water pitcher and pour a glass of water for Jane.

* * *

>i
You are carrying:
  water

>e
dining room
a lavish room with a long table that can sit at least 20 people in the middle. Wood shelves line the walls.

You can see shelves and a dining-table here.

>s
Main room
A large room that leads to an office to the west, a ballroom to the east, the dining room to the north. You see a staircase next to the dining room doorway.

You can see stairs here.

>up
hallway
A narrow hall with a floral carpet across the length. A bathroom is to the east and a bedroom to the north and west.

You can see stairs and Darcy here.

>e
bathroom
A bathtub is seated in the right corner and a toilet to the left. A sink with a mirror cabinet is against the wall to the left of the toilet.

You can see wash basin, toilet, cabinet (closed) and mirror here.

>w
hallway
A narrow hall with a floral carpet across the length. A bathroom is to the east and a bedroom to the north and west.

You can see stairs and Darcy here.

>n
north bedroom
A decent-sized room. A window is on the far wall and shelves line the wall to the left. A wardrobe is next to the window. You see Jane lying on the bed in the middle of the room.

You can see window (closed), wardrobe (closed) and Jane here.

>give water
(to Jane)
Jane looks refreshed and thanks you.

    *** You did your best to help your sister and it seems like she is getting better! THE END ***

Would you like to RESTART, RESTORE a saved game, QUIT or UNDO the last command?

* * *

>pour water
You take the water pitcher and pour a glass of water for Jane.

>s
office
A large room with a desk and sofas. Paintings hang on one wall and large windows are on another.

You can see kitchen-door, desk and Bingley here.

>e
Main room
A large room that leads to an office to the west, a ballroom to the east, the dining room to the north. You see a staircase next to the dining room doorway.

You can see stairs here.

>up
hallway
A narrow hall with a floral carpet across the length. A bathroom is to the east and a bedroom to the north and west.

You can see stairs and Darcy here.

* * *

>n
north bedroom
A decent-sized room. A window is on the far wall and shelves line the wall to the left. A wardrobe is next to the window. You see Jane lying on the bed in the middle of the room.

You can see window (closed), wardrobe (closed) and Jane here.

>give water
(to Jane)

    *** Jane thanks you for the water and she looks refreshed. You did your best to help your sister and it seems like she is getting better! THE END ***

Would you like to RESTART, RESTORE a saved game, QUIT or UNDO the last command?

>give water to jane
Please give one of the answers above.

Would you like to RESTART, RESTORE a saved game, QUIT or UNDO the last command?

>undo
north bedroom
[Previous turn undone.]

>undo
hallway
[Previous turn undone.]

>undo
Main room
[Previous turn undone.]

>n
dining room
A lavish room with a long table that can sit at least 20 people in the middle. Wood shelves line the walls.

You can see shelves and a dining-table here.

>give water to jane
You can't see any such thing.

* * *

>pour pitcher
You can't see any such thing.

>i
You are carrying:
  water

* * *

>n
(first opening kitchen-door)

kitchen
You can see kitchen-door and pitcher here.

>w
You can't go that way.

>n
You can't go that way.

>e
dining room
a lavish room with a long table that can sit at least 20 people in the middle. Wood shelves line the walls.

You can see shelves and a dining-table here.

* * *

>s
Main room
A large room that leads to an office to the west, a ballroom to the east, the dining room to the north. You see a staircase next to the dining room doorway.

You can see stairs here.

>n
dining room
a lavish room with a long table that can sit at least 20 people in the middle. Wood shelves line the walls.

You can see shelves and a dining-table here.

>s
Main room
A large room that leads to an office to the west, a ballroom to the east, the dining room to the north. You see a staircase next to the dining room doorway.

You can see stairs here.

>n
dining room
a lavish room with a long table that can sit at least 20 people in the middle. Wood shelves line the walls.

You can see shelves and a dining-table here.

It seems that Darcy appeared out of nowhere. He's just watching you. He'll leave soon.

>talk to darcy
Good day, Miss Elizabeth.

>ask darcy
You can't see any such thing.

* * *

>n
(first opening kitchen-door)

kitchen
You can see kitchen-door and pitcher here.

>e
dining room
A lavish room with a long table that can sit at least 20 people in the middle. Wood shelves line the walls.

You can see shelves and a dining-table here.

* * *

I beg your pardon?

>look under table
You see a cat!

* * *

You are Elizabeth Bennet, and you are at Mr. Bingley's Netherfield estate. Your sister Jane is sick, so you came to visit. You hope to try help her get back to health, but you mostly want to explore the place.

pride
Exploring the estate by Melissa Oshiro
Release 1 / Serial number 141022 / Inform 7 build 6L02 (I6/v6.33 lib 6/12N) SD

Main room
A large room that leads to an office to the west, a ballroom to the east, the dining room to the north. You see a staircase next to the dining room doorway.

You can see stairs here.

>n
dining room
A lavish room with a long table that can sit at least 20 people in the middle. Wood shelves line the walls.

You can see shelves and a dining-table here.

>s
Main room
A large room that leads to an office to the west, a ballroom to the east, the dining room to the north. You see a staircase next to the dining room doorway.

You can see stairs here.

>i
You are carrying nothing.

>n
dining room
a lavish room with a long table that can sit at least 20 people in the middle. Wood shelves line the walls.

You can see shelves and a dining-table here.

>i
You are carrying nothing.

>i
You are carrying nothing.

>w
kitchen
You can see kitchen-door and pitcher here.

>s
(first opening kitchen-door)

office
A large room with a desk and sofas. Paintings hang on one wall and large windows are on another.

You can see kitchen-door, desk and Bingley here.

>i
You are carrying nothing.

>w
You can't go that way.

>i
You are carrying nothing.

>s
You can't go that way.

>i
You are carrying nothing.

* * *

>w
You can't go that way.

>s
You can't go that way.

* * *

>n
dining room
A lavish room with a long table that can sit at least 20 people in the middle. Wood shelves line the walls.

You can see shelves and a dining-table here.

>look under table
You see a cat!

>x cat
A fat tabby cat with blue eyes. It seems curious about you, but it doesn't move.

>look under table
You see a cat!

>w
kitchen
You can see kitchen-door and pitcher here.

* * *

>i
You are carrying:
  water

>take all
That's not behavior befitting a lady.

>take pitcher
You can't see any such thing.

>i
You are carrying:
  water

>u
You can't go that way.

>undo
kitchen
[Previous turn undone.]

>undo
kitchen
[Previous turn undone.]

>undo
dining room
[Previous turn undone.]

>w
kitchen
You can see kitchen-door and pitcher here.

>take pitcher
Taken.

>pour water
You take the water pitcher and pour a glass of water for Jane.

* * *

>i
You are carrying:
  water

>e
dining room
A lavish room with a long table that can sit at least 20 people in the middle. Wood shelves line the walls.

You can see cat, shelves and a dining-table here.

>s
Main room
A large room that leads to an office to the west, a ballroom to the east, the dining room to the north. You see a staircase next to the dining room doorway.

You can see stairs here.

>up
hallway
A narrow hall with a floral carpet across the length. A bathroom is to the east and a bedroom to the north and west.

You can see stairs and Darcy here.

It seems that Darcy appeared out of nowhere. He's just watching you. He'll leave soon.

>n
north bedroom
A decent-sized room. A window is on the far wall and shelves line the wall to the left. A wardrobe is next to the window. You see Jane lying on the bed in the middle of the room.

You can see window (closed), wardrobe (closed) and Jane here.

>give water
(to Jane)
Jane looks refreshed.

>i
You are carrying nothing.

* * *

>look under table
You see a cat!

I beg your pardon?

>look under table
You find nothing of interest.

* * *

>look under table
You see a cat!

>pet cat
The tabby nuzzles into your hand and purs. She is very soft.

I beg your pardon?

* * *

You are Elizabeth Bennet, and you are at Mr. Bingley's Netherfield estate. Your sister Jane is sick, so you came to visit. You hope to try help her get back to health, but you mostly want to explore the place.

pride
Exploring the estate by Melissa Oshiro
Release 1 / Serial number 141022 / Inform 7 build 6L02 (I6/v6.33 lib 6/12N) SD

Main room
A large room that leads to an office to the west, a ballroom to the east, the dining room to the north. You see a staircase next to the dining room doorway.

You can see stairs here.

>up
hallway
A narrow hall with a floral carpet across the length. A bathroom is to the east and a bedroom to the north and west.

You can see stairs and Darcy here.

* * *

>n
north bedroom
A decent-sized room. A window is on the far wall and shelves line the wall to the left. A wardrobe is next to the window. You see Jane lying on the bed in the middle of the room.

You can see window (closed), wardrobe (closed) and Jane here.

>talk to jane
Jane smiles at you.

>ask jane about health
Jane has nothing to say about health. Try asking her about other things such as the window or Bingley.

>ask jane about health
Jane has nothing to say about health. Try asking her about other things such as the window or Bingley.

>ask jane about her health
I'm still feeling unwell. Hopefully I get better soon because I feel like a burden.

>ask jane about health
Jane has nothing to say about health. Try asking her about other things such as the window or Bingley.

>s
hallway
A narrow hall with a floral carpet across the length. A bathroom is to the east and a bedroom to the north and west.

You can see stairs and Darcy here.

>s
Main room
A large room that leads to an office to the west, a ballroom to the east, the dining room to the north. You see a staircase next to the dining room doorway.

You can see stairs here.

* * *

>e
ballroom
A large spacious room with marble floors and large windows on one wall. A grand chandelier hangs from the ceiling and marble columns near the walls. Paintings hang on all walls.

You can see piano and Miss Bingley here.

>play song
Play specific notes. Maybe a scale? A nice song?

>e
You can't go that way.

>w
Main room
A large room that leads to an office to the west, a ballroom to the east, the dining room to the north. You see a staircase next to the dining room doorway.

You can see stairs here.

* * *

>n
north bedroom
A decent-sized room. A window is on the far wall and shelves line the wall to the left. A wardrobe is next to the window. You see Jane lying on the bed in the middle of the room.

You can see window (closed), wardrobe (closed) and Jane here.

>ask jane abou how she feels
I didn't understand that sentence.

>ask jane about how she feels
Jane has nothing to say about how she feels. Try asking her about other things such as the window or Bingley.

>ask jane about her health
I'm still feeling unwell. Hopefully I get better soon because I feel like a burden.

* * *

>up
hallway
A narrow hall with a floral carpet across the length. A bathroom is to the east and a bedroom to the north and west.

You can see stairs and Darcy here.

>talk to darcy
Good day, Miss Elizabeth.

I beg your pardon?

* * *

>talk to darcy
Good day, Miss Elizabeth.

>ask darcy about jane
She's in the north bedroom.

>n
north bedroom
A decent-sized room. A window is on the far wall and shelves line the wall to the left. A wardrobe is next to the window. You see Jane lying on the bed in the middle of the room.

You can see window (closed), wardrobe (closed) and Jane here.

>s
hallway
A narrow hall with a floral carpet across the length. A bathroom is to the east and a bedroom to the north and west.

You can see stairs and Darcy here.

>s
You can't go that way.

>down
Main room
A large room that leads to an office to the west, a ballroom to the east, the dining room to the north. You see a staircase next to the dining room doorway.

You can see stairs here.

>up
hallway
A narrow hall with a floral carpet across the length. A bathroom is to the east and a bedroom to the north and west.

You can see stairs and Darcy here.

>down
Main room
A large room that leads to an office to the west, a ballroom to the east, the dining room to the north. You see a staircase next to the dining room doorway.

You can see stairs here.

>n
dining room
A lavish room with a long table that can sit at least 20 people in the middle. Wood shelves line the walls.

You can see shelves and a dining-table here.

>x rable
You can't see any such thing.

>x dining-table
A long mahogany table with chairs to match. A blue silk runner is positioned in the middle of the table. Candle holders are placed along the runner.

It seems that Darcy appeared out of nowhere. He's just watching you. He'll leave soon.

>talk to darcy
Good day, Miss Elizabeth.

>talk to darcy
You can't see any such thing.

>x table
A long mahogany table with chairs to match. A blue silk runner is positioned in the middle of the table. Candle holders are placed along the runner.

>look under table
You see a cat!

* * *

>pet cat
The tabby nuzzles into your hand and purs. She is very soft.

>x cat
A fat tabby cat with blue eyes. It seems curious about you, but it doesn't move.

>s
Main room
A large room that leads to an office to the west, a ballroom to the east, the dining room to the north. You see a staircase next to the dining room doorway.

You can see stairs here.

>w
office
A large room with a desk and sofas. Paintings hang on one wall and large windows are on another.

You can see kitchen-door, desk and Bingley here.

* * *

You are Elizabeth Bennet, and you are at Mr. Bingley's Netherfield estate. Your sister Jane is sick, so you came to visit. You hope to try help her get back to health, but you mostly want to explore the place.

pride
Exploring the estate by Melissa Oshiro
Release 1 / Serial number 141022 / Inform 7 build 6L02 (I6/v6.33 lib 6/12N) SD

Main room
A large room that leads to an office to the west, a ballroom to the east, the dining room to the north. You see a staircase next to the dining room doorway.

You can see stairs here.

>q
Are you sure you want to quit?

>w
Please answer yes or no.

* * *

>e
ballroom
A large spacious room with marble floors and large windows on one wall. A grand chandelier hangs from the ceiling and marble columns near the walls. Paintings hang on all walls.

You can see piano and Miss Bingley here.

>look at piano
A shiny, black grand piano. You know your sister Mary would fall in love with it.

>talk to Miss Bingley
Miss bingley asks you to play the piano.

>play the piano
That doesn't sound right.

>play piano
Play specific notes. Maybe a scale? A nice song?

>play scale
That doesn't sound right.

>play song
Play specific notes. Maybe a scale? A nice song?

>cdabefg
That's not a verb I recognise.

>anaconda
That's not a verb I recognise.

>play anaconda
My anaconda don't.

* * *

>w
Main room
A large room that leads to an office to the west, a ballroom to the east, the dining room to the north. You see a staircase next to the dining room doorway.

You can see stairs here.

>w
office
A large room with a desk and sofas. Paintings hang on one wall and large windows are on another.

You can see kitchen-door, desk and Bingley here.

>Bingley
That's not a verb I recognise.

>talk to Bingley
Bingley tells you that Jane is still a bit unwell, but no worries- she will be in good health soon. He has enjoyed her company thusfar.

It seems that Darcy appeared out of nowhere. He's just watching you. He'll leave soon.

>x me
You are Elizabeth Bennet, aka Lizzy. Your dress is slightly muddy from the walk to the estate and your hair is not in the best shape. Oh well.

>talk to Darcy
You can't see any such thing.

>w
You can't go that way.

* * *

>e
Main room
A large room that leads to an office to the west, a ballroom to the east, the dining room to the north. You see a staircase next to the dining room doorway.

You can see stairs here.

>w
office
A large room with a desk and sofas. Paintings hang on one wall and large windows are on another.

You can see kitchen-door, desk and Bingley here.

>n
(first opening kitchen-door)

kitchen
You can see kitchen-door and pitcher here.

>look at pitcher
A white clay water pitcher that has designs of birds and flowers on it. You should pour some water for Jane, maybe.

>pour water
You take the water pitcher and pour a glass of water for Jane.

>take glass
You can't see any such thing.

>take glass of water
You can't see any such thing.

>drink water
There's nothing suitable to drink here.

>e
dining room
A lavish room with a long table that can sit at least 20 people in the middle. Wood shelves line the walls.

You can see shelves and a dining-table here.

>s
Main room
A large room that leads to an office to the west, a ballroom to the east, the dining room to the north. You see a staircase next to the dining room doorway.

You can see stairs here.

It seems that Darcy appeared out of nowhere again. You ignore him.

>go u
hallway
A narrow hall with a floral carpet across the length. A bathroom is to the east and a bedroom to the north and west.

You can see stairs here.

>n
north bedroom
A decent-sized room. A window is on the far wall and shelves line the wall to the left. A wardrobe is next to the window. You see Jane lying on the bed in the middle of the room.

You can see window (closed), wardrobe (closed) and Jane here.

>give water to jane
    *** Jane thanks you for the water and she looks refreshed. You did your best to help your sister and it seems like she is getting better! THE END ***

Would you like to RESTART, RESTORE a saved game, QUIT or UNDO the last command?

>replay
Please give one of the answers above.

Would you like to RESTART, RESTORE a saved game, QUIT or UNDO the last command?

>restart
You are Elizabeth Bennet, and you are at Mr. Bingley's Netherfield estate. Your sister Jane is sick, so you came to visit. You hope to try help her get back to health, but you mostly want to explore the place.

pride
Exploring the estate by Melissa Oshiro
Release 1 / Serial number 141022 / Inform 7 build 6L02 (I6/v6.33 lib 6/12N) SD

Main room
A large room that leads to an office to the west, a ballroom to the east, the dining room to the north. You see a staircase next to the dining room doorway.

You can see stairs here.

>n
dining room
A lavish room with a long table that can sit at least 20 people in the middle. Wood shelves line the walls.

You can see shelves and a dining-table here.

>take all
That's not behavior befitting a lady.

>i
You are carrying nothing.

>look at shevles
You can't see any such thing.

>look at dining table
You can't see any such thing.

>pet cat
You can't see any such thing.

I beg your pardon?

>pet cat
You can't see any such thing.

>cat
That's not a verb I recognise.

>pet
What do you want to pet?

>cat
You can't see any such thing.

I beg your pardon?

>pet
What do you want to pet?

* * *

>cat
You can't see any such thing.

>pet cat
You can't see any such thing.

>pet lost cat
You can't see any such thing.

>x cat
You can't see any such thing.

>pet Cat
You can't see any such thing.

>xCat
That's not a verb I recognise.

>x Cat
You can't see any such thing.